10
20
1
1000
####################
#                  #
#           # #    #
#           #  #   #
#        x     # o #
#              #   #
#                  #
#      #####       #
#                  #
####################
