10
20
5
30 30 20 50 20
####################
#                 o#
#   o       #o#    #
#           #  #   #
#        x     #   #
#    o         #   #
#                  #
#      #####       #
#            o     #
####################
