10
10
3
20 20 20
##########
#        #
#    o   #
# o      #
#        #
#    o   #
#        #
#   x    #
#        #
##########