10
10
5
20 20 20 20 20
##########
#o      o#
#    o   #
#  o     #
#   x    #
#    o   #
#        #
#        #
#        #
##########