10
20
5
20 20 20 20 20
####################
#                 o#
#    o       o     #
#                  #
#        x         #
#    o             #
#                  #
#                  #
#            o     #
####################
