11
20
3
1000 1000 1000
####################
#                  #
#           #o#    #
#           # #    #
#           #  #   #
#        x     # o #
#              #   #
#                  #
#      #####       #
#        o         #
####################
