10
10
3
20 20 20
3333333333
3000000003
3100000003
3000001003
3000000003
3001000003
3000000003
3000200003
3000000003
3333333333     